11111111111111
10000000000001
10000010000011
10000000000011
11111111111111